10011000000100111000100111
00011000000100001000000100
00000000000100001000000100
00000000100100001000000100
10000000100100111000111100
11000000100000000000110000
10000100000000000000000000
10001100000000000000000000
00000100000111001100000000
00000000000000000111100000
00000000000000000000000000
00010000000000000000000100
00111110011101000000011111